320 100 320 270 180 270 180 160 170 160 170 270 100 270 100 280 320 280 320 350 290 350 290 360 330 360 330 100
160 150 130 150 130 120 120 120 120 160 160 160
110 110 150 110 150 100 100 100 100 180 150 180 150 210 100 210 100 260 160 260 160 250 110 250 110 220 160 220 160 210 160 170 110 170
80 360 280 360 280 350 90 350 90 200 140 200 140 190 90 190 90 90 160 90 160 120 170 120 170 90 240 90 240 120 200 120 200 130 150 130 150 120 140 120 140 140 170 140 170 150 180 150 180 140 190 140 190 160 200 160 200 140 210 140 210 130 240 130 240 150 240 160 240 170 190 170 190 180 240 180 240 210 230 210 230 230 210 230 210 240 240 240 240 220 250 220 250 90 280 90 280 150 290 150 290 90 330 90 330 80 80 80
140 300 140 290 100 290 100 300
120 230 120 240 140 240 160 240 160 230 160 230
250 230 250 240 290 240 290 200 280 200 280 230
260 220 270 220 270 200 260 200
200 250 200 210 190 210 190 260 310 260 310 180 260 180 260 190 300 190 300 200 300 250
190 300 300 300 300 310 190 310 190 320 310 320 310 290 190 290
310 330 180 330 180 290 150 290 150 330 110 330 110 320 140 320 140 310 100 310 100 340 160 340 160 300 170 300 170 340 310 340
190 110 230 110 230 100 180 100 180 120 190 120
270 160 270 100 260 100 260 170 310 170 310 100 300 100 300 160
220 150 210 150 210 160 230 160 230 140 220 140
230 200 230 190 190 190 190 200 210 200 210 220 220 220 220 200
